оперативный: оперативной Оперативная оперативная
она: Она она ее
обсуждать: обсуждаем
раздел: разделе разделы разделами
белый: белый Белый
покупать: покупать
гб: Гб ГБ
ёмкость: емкостью Емкость
ноутбучный: ноутбучным ноутбучного
увеличение: увеличение
строительство: строительства Строительство
владелец: владельцев
разрешение: разрешением разрешение разрешении Разрешение разрешения
находиться: находиться находится
наш: Наша
дафронтальный: ДаФронтальная
ммультраширокий: ммУльтраширокий
прислать: пришли
аксессуарынаручный: аксессуарыНаручные
свой: своими свое своей своего свой
модуляоснович: модуляОсновной
ммвес: ммВес
модуль: модуль модуля
батарея: Батарея батарея батареи
отсутствовать: отсутствует отсутствуют
оптическаяувеличение: оптическаяУвеличение
плавный: плавный
объединение: Объединение объединением
поскольку: поскольку
голубой: голубой
дамакрообъектив: ДаМакрообъектив
шустрый: шустрой
квадрокамера: Квадрокамера квадрокамеры
много: Много
изделие: изделия
так: т так
повседневный: повседневных повседневного повседневные
любой: любой Любой любую любые
часы: Часы часы
другой: другое других другой
расширение: расширения
а: А а
сумка: сумки Сумки
площадка: площадке
автокресло: Автокресла
являться: является
дисплей: дисплее дисплея дисплей Дисплей
продажецен: продажеЦены
отдельно: отдельно
самый: самых Самый самое самые
технология: технологией технологию Технология технологии
размер: размерами
контент: контента
гбоценка: ГбОценка
восстанавливать: восстанавливаю
передовой: передовыми передовую передовой
камера: камеру камеры камерой камерами камер камера Камера
большинство: большинством
интерфейс: интерфейса
мочь: можем может
генератор: Генераторы
защищать: защищает
пиковый: пиковую Пиковая Пиковую пиковая
титан: титана Титан титан
выбор: выбора Выбор выбором
подставка: Подставки
навигацияфункция: навигацияФункции
поддержка: поддержка поддержки поддержкой Поддержка
олеофобный: олеофобное
мпсветосила: МПСветосила
лицевой: Лицевую
чаша: чаши
лёт: лету
трио: трио
лайм: лайм Лайм
комплектация: комплектацию
иной: иные
выгодный: выгодной выгодное
москва: Москве Москва
новосибирск: Новосибирск Новосибирска
фр: Фр
гармонично: гармонично
женский: Женские
взаимодействие: взаимодействия
комфортный: комфортную
конкретный: конкретные
город: города город городу
прежний: прежним
графика: графики графикой
горелка: Горелки
нужный: нужный нужные нужную
мангал: Мангалы
трёхмерный: трехмерное
прочность: прочности
выполнить: выполнен
часбеспроводный: часБеспроводная
оснастить: оснащены оснащен оснащена
производительный: производительная производительный
будто: будто
мощность: мощности мощностью Мощность
инструмент: инструментом инструмент инструменты
топовый: топовыми Топовый топовых топовый Топовое топовая
гц: Гц
сбоку: сбоку
обзор: обзоры обзора
таковой: таковой
мой: моему
плюс: Плюс
всецело: всецело
влага: влаги
основный: основную Основную основная Основная
чуть: Чуть
компьютер: компьютеры Компьютеры
особенность: особенностей
столик: столики
мнение: Мнения мнения мнение
глянцевый: глянцевая глянцевое
отзыв: Отзывы отзывы
за: за За
светло: Светло светло
заявление: заявлениям
параметр: ПАРАМЕТРАМ параметрам
отмечать: отмечают
цена: ценам цене цены цен цена ценами
один: один Один
алфавитупо: алфавитупо
музыкальный: Музыкальные
использовать: используемого
карта: карт карта Карты карты Карта
физический: физическую физические
сайт: сайте Сайт сайт
аксессуар: аксессуаров
звук: звук звука
соответственно: соответственно
синий: Синий синий
мпвспышка: МПВспышка
менять: менять
радиатор: Радиаторы
общий: общей общий
сравнимый: сравнимым
вес: Вес вес
этот: этот этому
оптический: оптическим оптическая Оптическая Оптический оптической оптический
оз: ОЗУ
пеленальный: Пеленальные
связать: связал
тверь: Тверь
зарядка: зарядки зарядку зарядка зарядкой
польза: пользу
не: Не не
гарнитур: гарнитуры Гарнитуры
нит: нит
беспровод: Беспровод
обзавестись: обзавелся
видеокарта: Видеокарты видеокарт
подгузник: Подгузники
станда: станд
ремонт: ремонта Ремонт
характеристика: характеристиках Характеристики характеристики
серебристый: серебристый Серебристый
почти: почти
графит: графит Графит
товар: товаров Товары товаре товар товары товара
разработка: разработки разработка разработке
удобный: удобной удобный
данные: данных
запись: записи
необходимый: необходимыми
видео: видео
процессор: процессора процессоры процессор процессоре Процессор процессором
г: г
приставка: Приставки приставкой
уровень: уровня уровне уровень уровню
сожаление: сожалению
скоростной: скоростной
шт: шт
фотография: фотографии фотографию
два: два двух двумя
пикс: Пикс пикс
оборудовать: оборудованы оборудовали
объектив: Объективы объективы объектив объективов
мачтест: мАчТест
борт: борту
поступить: поступила
распознавание: распознавания
связь: связи связь Связь
соковыжималка: Соковыжималки
громкость: громкости
из: из Из
влагозащита: влагозащиту влагозащитой
память: память Память памяти
оптическаямакрообъектив: оптическаяМакрообъектив
адаптер: адаптера
полчаса: полчаса
аудио: аудио
фронт: Фронт
розовый: розовый
премиум: премиум
рамка: рамок рамкой рамки рамку рамками рамка
детализация: детализацию детализации
чёткость: четкости
подрасти: подросло подросла
информация: информация
регулировка: Регулировка
немой: нем
образный: образным
обсуждение: обсуждение
представить: представленная
глянцеваямаркировка: глянцеваяМаркировка
аппарат: аппаратом аппараты Аппарат
фантом: Фантом фантом
производитель: Производитель производителя
москвачелябинск: МоскваЧелябинск
устройс: устройс
материал: материалы Материал
ярославль: Ярославль
текстовый: текстовый
топ: топ
рассадить: рассажены
железо: железо
оптическаявспомогательный: оптическаяВспомогательный
электрочайник: Электрочайники
курск: Курск
галаксить: Галакси
руб: руб
я: Я мне
ультраширокий: Ультраширокий
мощный: мощный мощном мощных мощной мощного
матовый: матовое
втобщеевлагозащита: ВтОбщееВлагозащита
соответствовать: соответствующую
питание: питания питание
идти: идет ИДЕТ
меняться: меняется
название: названию
по: ПО По по
как: как Как
подробный: подробная
выглядеть: выглядит
сзамедлить: сЗамедленная
пилить: пилим
который: которые который которую которая котором которого которое
режим: режиме режимом режимов
способный: способна
изменение: изменение изменения Изменениям
функционал: функционал
детский: детские Детские
сохранять: сохраняя
модификация: модификацией
сша: США
сделать: сделана сделать
он: Его его он Он него
подключение: подключения
впечатляющий: впечатляющей впечатляющим
обсудить: обсудить
магазин: магазине магазин магазины магазинов магазинах магазина
сенсор: сенсора сенсором сенсор
наличие: наличии
отображать: отображает
графить: графи
часобщеевлагозащита: часОбщееВлагозащита
в: в В во
челябинск: Челябинске Челябинску Челябинск
лыжа: Лыжи
каждый: каждой каждом каждый
бок: бок
же: же
или: или
мп: МП Мп
недалеко: недалеко
весь: всю
стабилизация: стабилизацией стабилизации стабилизация
пе: пе
сочетать: сочетающий
система: Система системой систему система
стекло: стекло стекла
зонт: Зонты
подложка: подложки
функция: функцию Функции функциями
яркий: ярким яркий Яркий
профессиональный: профессиональных профессионального
требование: требованию
объём: Объем объем объемом
тип: Тип типа
тот: тех те
минвремя: минВремя
получить: получили получило получила
звезда: звездой
революционный: революционных Революционный
пластикзадний: пластикЗадняя
девайс: Девайс
звуковой: звуковых
дактилоскопический: дактилоскопический
обладать: Обладает обладает обладают
мобильный: мобильный мобильного Мобильный мобильному
привычный: привычного
почта: Почта
смартфон: смартфонов смартфоне Смартфон смартфоны смартфона смартфон Смартфоны
возможность: возможности возможность возможностями
способность: способностью
титановый: титанового титановый титановую титановой
поиск: поиск поиске поиска
проверка: проверки
экрансоотношение: экранСоотношение
технически: технически
новый: Новые новым новейший новые Новый новому новый нового
многофункциональный: многофункциональный
калибровка: калибровка
теперь: теперь Теперь
кабель: кабеле Кабели кабель
слот: Слота
чипсет: чипсета чипсетов чипсетами чипсет
освещение: освещения освещении
катушка: Катушки
быстрый: быстрой быструю быстрый
вибро: Вибро
что: что
крутой: крутыми
о: о О об
коммуникация: коммуникациям Коммуникация коммуникациями
украшение: украшения
давспышка: ДаВспышка
менеджер: менеджера менеджеров
искать: ищешь искать Искать Ищу
переход: переходам
также: также Также
частота: Частота частотой частота
реальность: реальности
придавать: придают
внутриканальный: внутриканальные Внутриканальные
составлять: составляет
рынок: рынка
мандарин: Мандарин
команда: команда команды
автотовар: автотовары
косметический: косметические
прочный: прочный
ювелирный: Ювелирные
россия: Россия России
установить: установлены
датчик: датчиком датчик
тонкий: тонкие
блендер: блендеры
операционный: Операционная
стаб: стаб стабом
закладка: Закладки
отправка: Отправка отправки
барометрнавигация: барометрНавигация
произво: произво
гбтонкий: ГбТонкий
чип: чипом чипа чип
кроватка: Кроватки
фотомодуль: фотомодуля
для: Для для
определяться: определяется
выход: выход выходе
слабый: слабой
хороший: хорошими
понадобиться: понадобится
фронтальный: Фронтальна Фронтальная
модель: модель моделями моделью Модель модели
они: ним
разгон: разгону
баллытелеобъектив: баллыТелеобъектив
написать: Напиши
цвет: Цвет цветов
матоваяразмер: матоваяРазмеры
область: области область
сравнение: сравнение сравнения Сравнение
многозадачность: многозадачности
отдыхвелосипед: отдыхВелосипеды
выпуск: выпуска
лицо: лица лице
вспышка: Вспышка вспышка
подвергнуть: подвергли
цифровой: цифровой цифровое
благодаря: Благодаря благодаря
серия: серии
водонагреватель: Водонагреватели
выводить: выводит
настраивать: настраиваемую настраиваемая настраиваю
графический: Графический графический
писать: писать пишите
стандарт: Стандарты стандарта стандарту
отвечать: отвечает
самсунг: Самсунг
ведущий: ведущего ведущим
драконовский: Драконовские драконовскими
выше: выше
клавиатура: Клавиатуры
ч: ч
переключатель: переключателя
ролик: Ролики
мур: Муром
обеспечивать: обеспечивает
там: там Там
дабеспроводный: ДаБеспроводная
производительность: производительности производительность Производительность
матрица: матрицей
телефон: Телефон телефон телефоны
кто: кто
картридж: Картриджи
глубина: глубину глубине
альтернативный: Альтернативно
штатив: Штативы
умный: умный
декор: Декор
сравнить: сравнить Сравнить
сенсорный: Сенсорны Сенсорный сенсорный
реверсивный: реверсивную реверсивная
моноколесо: моноколеса
эффективно: эффективно
обновление: обновления
зарядный: зарядное
макс: Макс
накладный: Накладные накладные
диагональ: Диагональ диагонали
вкладыш: Вкладыши вкладыши
класс: класса
пользователь: пользователю пользователя
сувенир: Сувениры
вода: воды
охрана: Охрана
шедевр: шедевр
камеракол: камераКол
насос: насосы Насосы
расположить: расположены
вплоть: вплоть
каталог: каталога Каталог каталог
фен: Фены
устройствокод: устройствоКод
встроить: встроенным встроенная встроенный Встроенный Встроенная
мультиварка: Мультиварки
экран: Экран экране экран экраны экраном экрана
тариф: тарифам
распоряжение: распоряжение
позволять: позволяющий позволяет
сверхпрочный: сверхпрочный
создатель: создателей
предложение: предложений предложение предложениям
компьютерный: Компьютерная
ускоренный: ускоренную
где: Где
подкрепляться: подкрепляется
камераформ: камераФорм
сортировка: Сортировка
воронеж: Воронеж
превосходный: превосходным
ггцкола: ГГцКол
москвановосибирсксанкт: МоскваНовосибирскСанкт
китай: Китая
задний: Задняя
предоплата: предоплате
принять: принять
внутри: внутри
фокусный: фокусное
хотеться: хочется
поддерживаться: Поддерживается
бесконтактный: бесконтактной
разогнать: Разогнанное разогнанного
бесплатно: бесплатно
базовый: базовой Базовый
офис: Офис
большущий: большущим
скоммуникация: сКоммуникация
тем: тем
увеличить: увеличили
накопитель: накопителя
записывать: записывать
фонарик: фонарик Фонарики
полноразмерный: полноразмерные Полноразмерные
крупный: Крупная
раз: раз
защитный: защитное
получаться: получаются
работа: работе работу работы работа
фото: Фото фото
пыл: пыле
обновляютсяпользоваться: обновляютсяпользоваться
легенда: легендой
заявить: заявлена заявленным
изогнутый: изогнутый
тренажёр: Тренажеры
комбинированный: комбинированные Комбинированные
размещаться: размещается
беспроводный: беспроводная беспроводной беспроводные Беспроводные беспроводную
пыль: пыли
лаванда: Лаванда лаванда
просмотр: просмотра
от: от От
высокий: высокий высокой высокого высокую
да: да Да
решение: решения решение
отличный: отличную отличным
справиться: справиться справится
панель: панель Панель
русифицировать: русифицирован
официальный: официальная официальный
подвергнуться: подвергся
похвастаться: похвастался похвастаться
обновля: обновле
купить: Купить купить
мятый: Мята
работать: работает работающий
совместить: совместить
на: на
миксер: Миксеры
комбинация: комбинация
мачмощность: мАчМощность
быстро: быстро
вычислительный: вычислительных
впечатление: впечатление
флагман: флагман
лестница: Лестница
защита: защиту защитой
профессио: профессио
станция: станции
переключение: переключения
самара: Самара
сенсорн: Сенсорн
главный: Главной
оперативка: оперативкой
матрицыувеличение: матрицыУвеличение
конфигурация: Конфигурация
яркость: яркость
голосовой: Голосовые
страна: стран
ниша: нише
свободный: свободное
форма: формой Форм
двухсторонний: двухстороннюю
быть: будет Е е была было
владивостокекатеринбургмосквачелябинск: ВладивостокЕкатеринбургМоскваЧелябинск
мы: мы Мы
выделяться: выделяются выделяется
тюнер: тюнеры
вт: Вт
вариант: Варианты
покупатель: покупателю
задача: задачи задач задача
предоставлять: предоставляя
лавандовый: лавандовый Лавандовый
стереозвук: стереозвук
золотой: золотой
определить: определить
телеобъектив: телеобъектив
хватить: хватит
заметный: Заметное
пк: ПК
дорожный: дорожные
и: и
предыдущий: предыдущем предыдущей
видеосъемкафотоаппарат: видеосъемкаФотоаппараты
кам: кам
планироваться: планируется
совершенно: совершенно
линейка: линейке линейки
год: Год год году
программа: программы
тут: тут
каплевиднаяоснович: каплевиднаяОсновной
игра: игр
продвинуть: продвинутым Продвинутая продвинутых продвинутой
группа: групп группы
чёрный: черный Черный
стиль: стиле стилей
чемодан: Чемоданы
жизнь: жизни
пока: пока
аппаратный: Аппаратная аппаратную аппаратной
версия: версия версии Версия
вместимость: вместимостью
нерасширяемый: нерасширяемого
решать: решать
остальной: остальные
спорт: Спорт
аккумулятор: аккумулятора Аккумулятор Аккумуляторы аккумулятор
ра: ра
сорянин: СОРЯН
апскейлер: апскейлером апскейлер
вк: ВК
пункт: пунктам
спб: СПБ
план: плане
баллытехнология: баллыТехнология
помимо: помимо
скорость: скоростью
самовывоз: Самовывоз самовывоз
с: со с С
страница: странице страница
всё: все
барбекю: барбекю
охватывать: охватывать
трёхкратный: трехкратным
фон: фоне
съёмка: съемка Съемка съемки
вып: вып выпу
луч: лучей
уйти: ушла
доставка: доставка доставкой Доставка
х: х
можно: можно
способ: способ
сстабилизация: сСтабилизация
сдек: СДЕК
то: то
гироскоп: гироскоп
стабилизатор: стабилизаторы
трассировка: трассировку трассировкой
есть: Есть есть
конструкция: Конструкция
баллыосновный: баллыОсновная
смарт: Смарт
плоский: плоской
блочок: блочок
тоже: тоже
стать: стать станет стал
устройство: устройство устройства устройству Устройство
крышка: крышки крышка
история: История
закалённый: закаленного
заводский: заводскому
автономность: автономностью
проводной: Проводные проводные проводную
автомасло: Автомасла
дрон: дроны
день: день дни дней
предусматриваться: предусматривается
вырез: вырезом вырез
тест: теста
стильный: Стильный стильный
максимум: максимуму
серьёзно: серьезно
гбодин: ГбОдин
гбот: Гбот
большой: большой больше большому Большой
поддерживать: поддерживающим поддерживает
проектор: Проекторы
автономный: автономную автономной
плашка: плашке
духовка: Духовки
наиболее: наиболее
компаспитаниемощность: компасПитаниеМощность
разрешать: разрешающей
плохой: плохом
ммвспышка: ммВспышка
нетребовательный: нетребовательных
комбайн: Комбайны
ёмкостный: емкостный
телевикома: телевиком
высокопроизводительный: высокопроизводительные
прошка: прошке
нижний: Нижний
достигать: достигает
принцип: принципу
супермощный: супермощный
флагманский: Флагманские флагманского флагманский
элемент: элементы
магнитола: Магнитолы
спальная: Спальные
стабильный: стабилен
внутренний: внутренним внутреннюю
себя: собой себе
кнопка: кнопка кнопку
интернет: интернет
впервые: впервые
мясорубка: Мясорубки
хлебопечка: Хлебопечки
бежевый: Бежевый бежевый
изображение: изображения
оставаться: остается
широко: широко
цв: цв
встречать: Встречайте встречает
вылазить: вылазит
мпсъёмка: МПСъемка
удобно: удобно
тепловой: Тепловые
время: время времени Время
занимать: занимает
соцсеть: соцсетях
частьоперационный: частьОперационная
низкий: низкая
остаться: осталась остался
выраженный: выраженной
корпус: корпуса корпусе корпус
спасибо: Спасибо
глонасс: ГЛОНАСС
фрон: Фрон
холодильник: Холодильники
митино: Митино
гаджет: Гаджет гаджета
это: это
чиппорт: чипПорты
диапазон: диапазоне
продумать: продуманную
категория: категории
второй: второй
вместе: Вместе вместе
техниканоутбук: техникаНоутбуки
поверхность: Поверхность поверхность
п: П
однако: Однако однако
нм: нм
шанс: шансы
лаконичный: лаконичном
кануть: канувшие
зум: зум зумом
глянцеваяразмер: глянцеваяРазмеры
формат: формате
лишиться: лишилась
волоколамский: Волоколамская
конец: Конец
телеграм: телеграм
предшественник: предшественника
портативный: Портативные
компаспитаниеемкость: компасПитаниеЕмкость
рубль: рублей
мебель: Мебель
си: си
гбцвета: ГбЦвет
сотрудник: сотрудников
оставить: оставили
чебоксары: Чебоксары
гбмнение: ГбМнения
спутниковый: спутниковой спутниковая
полезный: полезные
телевика: телевик телевиками
ультразвуковой: ультразвуковому ультразвуковой
бренд: Бренд
след: След
пластик: пластик
перископный: перископный
еас: ЕАС
помощь: помощью
мешок: мешки
тактовый: тактовая
многое: многое
отладка: ОТЛАДКА
доработать: доработала
оплата: оплаты
складывание: складывания
практически: практически
акустика: Акустика
стедикам: Стедикамы
максимальный: максимальная Максимальный
консультация: консультация
храниться: хранится
помочь: поможет Помоги
браслет: браслеты
зелёный: Зеленый зеленый
бе: Бе
живой: живые
принести: принесла
разговор: разговора
восьмиядерный: восьмиядерного
гироборд: Гироборды
снизиться: снизился
развлечение: развлечения
гарантия: Гарантия гарантия
экстренный: экстренной
светосила: Светосила
авто: Авто
канал: канал
сюда: сюда
пиксель: пикселей
обработать: обработанных
придача: придачу
устро: устро
блок: блок
свойство: свойств
металл: металл
видеть: видеть
вхшхта: ВхШхТ
производство: производстве
обеспечить: обеспечит
устилать: устилает
гцсоотношение: ГцСоотношение
порядок: порядок
забота: заботой
серебряный: Серебряный
бесплатный: бесплатная бесплатной
манер: манер
универсальный: универсальная универсальный универсальную
подходящий: подходящего
ошибка: ошибки
снаряжение: снаряжение
оригинальный: оригинальных
передний: переднюю
батарейка: батарейки
волшебный: волшебный
далее: д
переработать: переработанные
сдэк: СДЭК
стиральный: Стиральные
гаджетымобильный: гаджетыМобильные
алюй: алюми
развлекательный: развлекательных
восстановить: восстановленный восстановлен восстановить
термос: Термосы
видеорегистратор: Видеорегистраторы
кол: Кол
видеотелевизор: видеоТелевизоры
удилище: Удилища
отсутствуеткол: отсутствуетКол
посуда: Посуда
под: под
транслировать: транслирует
использование: использования
скорее: скорее
качественный: качественная
согласно: Согласно
ты: тобой тебе
рифленаяразмер: рифленаяРазмеры
сородич: сородичей
район: район
гбслот: ГбСлот
узнавать: узнаваемый
мачтехнология: мАчТехнология
заряжаться: заряжается
погружение: погружение
презентация: презентации
док: док
центр: центре
показать: Показать показать
сканер: сканер
стабилизировать: стабилизированным
только: только
прикрытие: прикрытием
пик: Пик
мина: мин
дизайн: дизайн
боков: боковой
вы: вы
телега: телегу
отметить: Отметим
мач: мАч
начало: Начало
бот: бота боту
кремовый: Кремовый кремовый
санкт: Санкт
дисплейосновный: ДисплейОсновной
островной: островном островная
водоснабжениекондиционер: водоснабжениеКондиционеры
сплав: сплава
экология: экологии
изготовить: изготовленный
гкомплектация: гКомплектация
бытовой: Бытовая бытовая
впредь: впредь
оформление: оформления
напоминать: напоминающей
соотношение: Соотношение
десятикратное: десятикратным
дюйм: дюймов
дополнить: дополненной
ма: мА
доступный: доступен
количество: Количество
электроника: электроника
совпадать: совпадают
если: если
нагрузка: нагрузку
наименее: наименее
выходной: выходные
при: при
сотовый: Сотовый
скорый: скором
товарный: Товарная
курьерский: курьерская
м: м
капот: капотом
оптика: оптикой
передача: передачи
пи: ПИ
перо: перо пере
у: У у
ручной: Ручной ручные
сдоп: сДоп
гбосновный: ГбОсновная
улучшить: улучшена улучшенной
такой: таким такой
мо: Мо
возможный: возможна
оп: Оп
краснодар: Краснодар
стан: стан
техникакофеварка: техникаКофеварки
наладить: налажена
ленинградский: Ленинградской
железный: железная железном
рф: РФ
втмощность: ВтМощность
использоваться: используются используется
новгород: Новгород
семейство: семейства
ремонтсантехник: РемонтСантехника
мм: мм
увлечение: увлечений
стаби: стаби
втвремя: ВтВремя
ядро: ядер
переосмыслить: Переосмысленный
нитсоотношение: нитСоотношение
дааппаратный: ДаАппаратная
фронталь: Фронталь
разъём: Разъем
микрофон: Микрофон
снимок: снимков
укомплектовать: укомплектована
москвасанкт: МоскваСанкт
мпикс: МПикс
прямоугольный: прямоугольной
между: между
графитовый: Графитовый графитовый
моноблок: моноблок Моноблок
шумоподавление: шумоподавление
расставить: расставлены
покрытие: покрытие
уфа: Уфа
пылесос: Пылесосы
гббазовый: ГбБазовая
даоптический: ДаОптический
допилить: допилили
добавить: добавила добавлен
дом: дом
гбный: ГбНа
тб: ТБ
более: более
климат: Климат
ультра: Ультра
разный: разных
минимальный: минимальной
иметь: имеет
заменять: заменяющая
выступать: выступающей
петербург: Петербург
увлажнитель: Увлажнители
список: списком СПИСКОВ
традиция: традициям
разнообразный: разнообразные
назначить: назначить
мпультраширокий: МПУльтраширокий
ссъёмка: сСъемка
конёк: Коньки
кофемашин: кофемашины
легко: легко
провод: проводу
колонка: колонки Колонки
ггц: ГГц
появиться: появился
к: к К
глазок: глазок
подбор: ПОДБОР подбор
жёлтый: Желтый
отличие: отличие
клавиша: клавишу клавиши
крепление: крепления
липецк: Липецк
гбвстроить: ГбВстроенная
отказаться: отказались
промышленность: промышленности
определение: определения
владивосток: Владивосток
вс: вс
таки: таки
бумага: Бумага
ёмкий: Емкой
мятный: мятный Мятный
уценить: уцененный
середина: серединой
несколько: несколько
лично: лично
оборудование: оборудование
самокат: Самокаты
создание: создания
новшество: новшеств
дюймовый: дюймовый
гаджетыкомпьютерыаудио: ГаджетыКомпьютерыАудио
активный: активный
канцелярия: Канцелярия
квалифицировать: квалифицированная
квадрокоптер: Квадрокоптеры
поколение: поколения поколении
зоотовар: Зоотовары
канцеляриямфа: канцелярияМФУ
гражданин: граждан
внимание: ВНИМАНИЕ Внимание внимания
воспользоваться: воспользоваться
серый: Серый серый
предел: пределы
именно: именно
прекратить: ПРЕКРАТИЛ
зуммирование: зуммированием
премиальный: премиальный
ультраширик: ультрашириком
отпечаток: отпечатка
элегантный: Элегантный
картинка: картинку
ускоритель: ускоритель
техникаклиматинструментавто: техникаКлиматИнструментАвто
тв: ТВ
описание: описание
комплектующие: комплектующие Комплектующие
китайский: китайского
петербургчелябинск: ПетербургЧелябинск
мотошина: мотоШины
основной: основной основные Основной
обычный: обычные
прочий: прочих
прим: прим
отверстие: отверстии
произодитель: Произодители
полностью: полностью
начинка: начинка
штатный: штатную
гбвысказать: ГбВысказать
садовый: Садовая
пэк: ПЭК
московский: Московская
выходить: выходя
бескомпромиссный: бескомпромиссную
вместо: вместо Вместо
ключевой: ключевым
кратный: кратный
сочный: Сочный
велосипед: Велосипеды
сердце: Сердцем
машина: машины
повреждение: повреждений
наушник: Наушники наушники
лишь: лишь
сверхширика: сверхширик
закрытый: закрытые
нет: нет
освещённость: освещенности
тула: Тула
заполучить: заполучила
входить: входит
данный: данного
портыстандарт: портыСтандарты
стилус: стилус
аудиотехниканаушник: АудиотехникаНаушники
сдвиг: сдвиг
фиолетовый: фиолетовый Фиолетовый
тд: тд
втбыстрый: ВтБыстрая
млн: млн
игрушкиколяска: игрушкиКоляски
общение: общения
планшет: Планшеты
туризм: Туризм
расстояние: расстояние
чёткий: четкий
до: до
образ: образом
вечером: вечером
зарядить: заряженной
котёл: Котлы
энергоёмкий: Энергоемкий
находить: находить
делать: делать
факс: Факсы
сварочный: Сварочные
условие: условиях
матрас: Матрасы
хранилище: хранилищем
антикоррозионный: антикоррозионных
вытяжка: Вытяжки
минмощность: минМощность
сам: самой
соседний: соседних
фактор: фактор
порт: порта
туристический: туристическое
значение: значения
кормление: кормления
рязань: Рязань
владивостокмосквачелябинск: ВладивостокМоскваЧелябинск
простой: простого
втбеспроводный: ВтБеспроводная
поворотный: поворотные
медиаплеер: Медиаплееры
кадр: кадр
идеал: идеала
тройной: Тройная
плита: Плиты
ещё: Еще еще
новинка: Новинка
ру: РУ
камин: Камины
оптить: Опти
точка: точку
гбитый: Гбит
ресурс: ресурс
ниже: ниже
удаться: удалось
сервис: сервис
идентификация: идентификации
нитаппаратный: нитАппаратная
рыбалкапалатка: рыбалкаПалатки
выпускаться: выпускаются
разработать: разработана
тыльный: тыльного
кредит: кредит
натуральный: Натуральный
безусловно: безусловно
гбгде: ГбГде
диск: Диски
объединить: объединили
телекамера: Телекамера
мл: мл
гмаркировка: гМаркировка
красный: красный
утверждать: утверждает
ме: ме
мбитый: Мбит
отдельность: отдельности
дабыстрый: ДаБыстрая
фильтр: Фильтры
копейск: Копейске
скейтборд: Скейтборды
проекционный: Проекционные
эргономика: эргономику
невероятный: невероятной
техникавстраивать: техникаВстраиваемая
стульчик: Стульчики
мелкий: Мелкая
стандартный: стандартных
помогать: помогать
позволить: позволят
сочетаться: сочетаются
технический: технические
игрушка: Игрушки
принтер: Принтеры
переопределять: переопределяет
вентилятор: Вентиляторы
проприетарный: проприетарная
ссылка: ссылки
кратное: кратным
гбещё: Гбеще
екатеринбург: Екатеринбург
аудиосистема: Аудиосистемы
свобода: свободу
заимствовать: заимствовал
пред: Пред
сигнализация: Сигнализации
гофициальный: гОфициальный
посетитель: посетителей
одночасье: одночасье
ультратонкий: ультратонкими
владивостокмосквановосибирскчелябинск: ВладивостокМоскваНовосибирскЧелябинск
монитор: Мониторы
атрибут: атрибуты
техника: техника
ценыпо: ценыпо
снизуфункция: снизуФункции
фирменный: фирменных
ос: ОС
селфи: Селфи
ли: ли
возрастание: возрастанию
приближение: приближением
еврокомиссия: Еврокомиссии
дтп: ДТП
больший: большим
оптическаятелеобъектив: оптическаяТелеобъектив
никакой: никаких
освещениянавигация: освещенияНавигация
москвановосибирскчелябинск: МоскваНовосибирскЧелябинск
ожидание: ожидания
видеосъёмка: видеосъемки
инструментэлектроинструмент: ИнструментЭлектроинструмент
свспышка: сВспышка
всегда: всегда
предлагать: предлагает
адаптивный: адаптивной
сугол: сУгол
го: го
обогреватель: Обогреватели
предводительство: предводительством
