обсуждать: обсуждаем
помочь: поможет Помоги
живой: живые
кроватка: Кроватки
блок: блок
инструмент: инструменты Инструмент инструмент
фото: Фото фото
электроника: электроника
такой: такой
звук: звук
дрон: дроны
россия: России Россия
работа: работу работе работы
вытяжка: Вытяжки
прекратить: ПРЕКРАТИЛ
скорый: скором
сумка: Сумки сумки
каталог: каталога Каталог каталог
стиральный: Стиральные
барбекю: барбекю
колонка: колонки Колонки
технический: технические
телеграм: телеграм
подробный: подробная
аксессуар: аксессуары
женский: Женские
компьютер: Компьютеры компьютеры
модуль: модуля
для: для Для
пеленальный: Пеленальные
восстановить: восстановить восстановлен восстановленный
автомасло: Автомасла
создание: создания
музыкальный: Музыкальные
термос: Термосы
пикс: пикс
смартфон: Смартфон смартфонов Смартфоны
охрана: Охрана
поиск: поиска поиск поиске
скейтборд: Скейтборды
игрушка: Игрушки игрушки
тюнер: тюнеры
бытовой: бытовая Бытовая
я: мне
насос: насосы Насосы
сервис: сервис
посуда: Посуда
принтер: Принтеры
офис: Офис
туристический: туристическое
находить: находить
ресурс: ресурс
сварочный: Сварочные
сравнить: сравнить
информация: информация
пилить: пилим
телефон: телефоны
детский: детские Детские
выгодный: выгодное
страница: странице
доступный: доступен
список: списком
велосипед: Велосипеды
бумага: Бумага
ручной: ручные Ручной
официальный: официальный
позволять: позволяющий
задача: задача
ювелирный: Ювелирные
написать: Напиши
водонагреватель: Водонагреватели
холодильник: Холодильники
матрас: Матрасы
большой: большому
сенсорный: сенсорный
фотоаппарат: Фотоаппараты
категория: категории
климат: Климат
полезный: полезные
разработка: разработка разработки разработке
сравнение: сравнение сравнения
видеокарта: видеокарт Видеокарты
мясорубка: Мясорубки
поддержка: поддержка
восстанавливать: восстанавливаю
ссылка: ссылки
монитор: Мониторы
строительство: строительства Строительство
комбайн: Комбайны
видео: видео
проекционный: Проекционные
туризм: Туризм
гаджет: Гаджеты гаджеты
видеосъёмка: видеосъемка
картридж: Картриджи
телега: телегу
тренажёр: Тренажеры
внимание: Внимание ВНИМАНИЕ
питание: питание
палатка: Палатки
лестница: Лестница
развлечение: развлечения
удобный: удобный
штатив: Штативы
клавиатура: Клавиатуры
где: Где
нужный: нужные нужный
коляска: Коляски
мультиварка: Мультиварки
камин: Камины
купить: купить
электроинструмент: Электроинструмент
предложение: предложение
спорт: Спорт
кофемашин: кофемашины
мешок: мешки
шина: Шины
рыбалка: рыбалка
сделать: сделать
объектив: объектив Объективы объективов
время: время времени
так: так
свободный: свободное
цена: цен цены ценами
раздел: разделами разделы разделе
подбор: подбор
ноутбук: Ноутбуки
компьютерный: Компьютерная
вечером: вечером
многофункциональный: многофункциональный
моноколесо: моноколеса
который: которая
меняться: меняется
наручный: Наручные
радиатор: Радиаторы
карта: Карты
катушка: Катушки
почти: почти
столик: столики
наш: Наша
режим: режиме
охватывать: охватывать
гарнитур: Гарнитуры
порядок: порядок
ты: тобой
себя: собой
техника: техника
что: что
активный: активный
пылесос: Пылесосы
характеристика: характеристики
именно: именно
чемодан: Чемоданы
товар: товаров товары
магазин: магазинах магазинов
автотовар: автотовары
горелка: Горелки
свой: свой
стабилизатор: стабилизаторы
настраивать: настраиваю
каждый: каждой каждом каждый
фен: Фены
фонарик: Фонарики
определить: определить
между: между
канал: канал
самый: самое самые
как: как
автокресло: Автокресла
писать: пишите писать
принять: принять
электрочайник: Электрочайники
подгузник: Подгузники
съёмка: Съемка
если: если
спасибо: Спасибо
ролик: Ролики
функционал: функционал
машина: машины
часы: часы Часы
отдых: отдых
плита: Плиты
встраивать: Встраиваемая
олеофобный: олеофобное
диск: Диски
аккумулятор: Аккумуляторы
выходной: выходные
проектор: Проекторы
соковыжималка: Соковыжималки
тот: тех
квадрокоптер: Квадрокоптеры
остальной: остальные
магнитола: Магнитолы
вес: Вес
искать: Искать ищешь искать
помогать: помогать
изогнутый: изогнутый
сожаление: сожалению
конёк: Коньки
определяться: определяется
всё: все
лично: лично
покупатель: покупателю
быть: было будет
кофеварка: Кофеварки
модель: модели Модель
акустика: Акустика
мелкий: Мелкая
отзыв: отзывы
мобильный: Мобильные
появиться: появился
декор: Декор
экран: экран экраны
обогреватель: Обогреватели
дисплей: дисплей
кормление: кормления
сувенир: Сувениры
гироборд: Гироборды
наименее: наименее
там: там Там
видеорегистратор: Видеорегистраторы
генератор: Генераторы
подставка: Подставки
стабильный: стабилен
наушник: Наушники
блендер: блендеры
руб: руб
покрытие: покрытие
находиться: находится находиться
другой: другое
планшет: Планшеты
связать: связал
удобно: удобно
память: память памяти
кабель: Кабели
авто: Авто
дом: дом
посетитель: посетителей
полностью: полностью
обновляться: обновляются
сантехника: Сантехника
день: день дни
зоотовар: Зоотовары
дорожный: дорожные
новый: новый
медиаплеер: Медиаплееры
конкретный: конкретные
смарт: Смарт
стульчик: Стульчики
кол: Кол
телевизор: Телевизоры
ремонт: ремонта Ремонт
аудио: Аудио
сайт: Сайт сайт
площадка: площадке
переход: переходам
батарейка: батарейки
мебель: Мебель
идти: идет
выбор: выбором Выбор
только: только
кто: кто
крепление: крепления
аппарат: аппараты
процессор: процессора
многое: многое
снаряжение: снаряжение
хотеться: хочется
разнообразный: разнообразные
духовка: Духовки
или: или
мфу: МФУ
удилище: Удилища
спальная: Спальные
описание: описание
планироваться: планируется
самокат: Самокаты
стедикам: Стедикамы
зонт: Зонты
топ: топ
основной: Основной
хлебопечка: Хлебопечки
оперативный: Оперативная
мой: моему
интернет: интернет
быстро: быстро
камера: камеры
портативный: Портативные
аудиосистема: Аудиосистемы
канцелярия: Канцелярия канцелярия
водоснабжение: водоснабжение
умный: умный
можно: можно
возможность: возможность
комплектующие: Комплектующие
пользоваться: пользоваться
связь: Связь
украшение: украшения
ошибка: ошибки
увлажнитель: Увлажнители
сигнализация: Сигнализации
ещё: еще
сюда: сюда
аудиотехника: Аудиотехника
название: названию
проводной: Проводные
тепловой: Тепловые
гражданин: граждан
мото: мото
браслет: браслеты
оборудование: оборудование
лыжа: Лыжи
приставка: Приставки
кондиционер: Кондиционеры
обсудить: обсудить
мочь: можем
текстовый: текстовый
мангал: Мангалы
миксер: Миксеры
решение: решение
факс: Факсы
вентилятор: Вентиляторы
крупный: Крупная
садовый: Садовая
котёл: Котлы
параметр: параметрам
