бежевый: Бежевый бежевый
помочь: поможет
мач: мАч
блок: блок
фото: Фото фото
электроника: электроника
максимум: максимуму
переопределять: переопределяет
поддерживать: поддерживает
москва: Москва
россия: России Россия
сорянин: СОРЯН
обновление: обновления
защитный: защитное
стандарт: стандарта
отличный: отличную
мобильный: Мобильный мобильного
чёрный: черный Черный
челябинск: Челябинску Челябинске Челябинск
скорый: скором
распоряжение: распоряжение
доставка: Доставка доставка
модификация: модификацией
технический: технические
стабилизация: стабилизации стабилизация
камера: камеру камера Камера камеры
нерасширяемый: нерасширяемого
санкт: Санкт
подробный: подробная
кам: кам
также: Также также
компьютер: Компьютеры компьютеры
модуль: модуля
трио: трио
карта: карты карта Карта
для: для Для
восстановить: восстановить восстановлен восстановленный
фотомодуль: фотомодуля
смартфон: Смартфон смартфон смартфоны смартфона
центр: центре
поиск: поиска поиск
год: год
мпикс: МПикс
бытовой: бытовая Бытовая
любой: любые любой Любой
я: мне
сервис: сервис
интерфейс: интерфейса
фактор: фактор
основный: основная основную Основная
драконовский: драконовскими Драконовские
туристический: туристическое
стиль: стилей
цвет: цветов
находить: находить
ресурс: ресурс
купить: Купить купить
этот: этот
сравнить: сравнить
информация: информация
пилить: пилим
середина: серединой
обладать: обладает
детский: детские
аккумулятор: Аккумулятор аккумулятора аккумулятор
выгодный: выгодное
страница: странице
устройство: устройства
совпадать: совпадают
выступать: выступающей
доступный: доступен
список: списком СПИСКОВ
официальный: официальный
позволять: позволяющий
устилать: устилает
система: системой система
задача: задача задачи
пыль: пыли
стаби: стаби
район: район
инструмент: Инструмент
топовый: топовыми
сенсорный: сенсорный Сенсорный Сенсорны
подложка: подложки
панель: панель
категория: категории
соцсеть: соцсетях
климат: Климат
полезный: полезные
разработка: разработка разработке
скоростной: скоростной
сравнение: сравнение сравнения
частота: частотой Частота
зелёный: Зеленый зеленый
себя: себе собой
формат: формате
ссылка: ссылки
процессор: процессоре Процессор процессоры процессора процессор
тыльный: тыльного
выделяться: выделяется
строительство: строительства
видео: видео
технология: технологию
гаджет: Гаджеты гаджета
цена: ценам цен цены цена ценами
революционный: Революционный
телега: телегу
внимание: Внимание внимания
минимальный: минимальной
эффективно: эффективно
работа: работе работы
выбор: выбора выбором
спб: СПБ
новосибирск: Новосибирска Новосибирск
удобный: удобный
где: Где
нужный: нужные
отправка: Отправка
чипсет: чипсета чипсетами
вместимость: вместимостью
устро: устро
корпус: корпуса
яркость: яркость
предложение: предложение
разный: разных
сканер: сканер
являться: является
количество: Количество
возможный: возможна
время: время времени
отдельность: отдельности
группа: групп
белый: белый
жизнь: жизни
форма: Форм
производительный: производительный производительная
так: так
свободный: свободное
самовывоз: Самовывоз
подбор: подбор
подходящий: подходящего
зарядка: зарядку зарядки
датчик: датчик
изображение: изображения
вечером: вечером
встроить: встроенный встроенная Встроенная
многофункциональный: многофункциональный
который: которая
меняться: меняется
предоплата: предоплате
производитель: Производитель
фильтр: Фильтры
почти: почти
наш: Наша
режим: режиме
пикс: Пикс
пиковый: пиковую
премиум: премиум
охватывать: охватывать
бок: бок
чип: чип
дюйм: дюймов
шустрый: шустрой
телефон: Телефон телефон
характеристика: характеристики Характеристики
техника: техника
что: что
именно: именно
фронтальный: Фронтальная
отметить: Отметим
товар: товаров товары
магазин: магазинах магазины магазин магазинов
автотовар: автотовары
сочный: Сочный
фантом: Фантом фантом
оперативный: оперативная оперативной Оперативная
ядро: ядер
пиксель: пикселей
раздел: разделы разделе
каждый: каждой каждом каждый
между: между
самый: самое самые
как: как
расположить: расположены
писать: пишите писать
принять: принять
тип: типа Тип
лаванда: Лаванда
глонасс: ГЛОНАСС
съёмка: Съемка
если: если
выпускаться: выпускаются
идти: ИДЕТ идет
базовый: базовой
дактилоскопический: дактилоскопический
область: область области
линейка: линейки
легко: легко
выходной: выходные
транслировать: транслирует
атрибут: атрибуты
влагозащита: влагозащиту
плоский: плоской
тот: тех
вес: Вес
искать: Искать Ищу искать
помогать: помогать
сотовый: Сотовый
гарантия: Гарантия
тем: тем
отзыв: Отзывы отзывы
поступить: поступила
при: при
волоколамский: Волоколамская
модель: моделью модели Модель модель
флагманский: Флагманские флагманский
митино: Митино
сайт: сайте сайт
определяться: определяется
всё: все
железный: железная
вплоть: вплоть
покупатель: покупателю
коммуникация: коммуникациям
зарядить: заряженной
диагональ: диагонали
защита: защитой
оптический: Оптическая оптическим
млн: млн
экран: экран экране Экран экрана
город: город
копейск: Копейске
картинка: картинку
розовый: розовый
наименее: наименее
телевика: телевик
графика: графики
накопитель: накопителя
стабильный: стабилен
принцип: принципу
беспровод: Беспровод
супермощный: супермощный
руб: руб
сверхширика: сверхширик
укомплектовать: укомплектована
бесплатно: бесплатно
дисплей: дисплея Дисплей
повседневный: повседневные
ггц: ГГц
находиться: находится находиться
другой: другое
проверка: проверки
тариф: тарифам
удобно: удобно
память: память Память памяти
товарный: Товарная
авто: Авто
там: Там
полностью: полностью
день: день дни
способ: способ
глазок: глазок
новый: новый
кремовый: Кремовый кремовый
конкретный: конкретные
отладка: ОТЛАДКА
версия: версия
нит: нит
ленинградский: Ленинградской
кол: Кол
ёмкость: емкостью
ремонт: ремонта
аудио: Аудио
площадка: площадке
бренд: Бренд
заявить: заявленным
моноблок: Моноблок
яркий: яркий
стаб: стабом
создатель: создателей
кто: кто
класс: класса
рассадить: рассажены
переосмыслить: Переосмысленный
многое: многое
разрешение: разрешении
снаряжение: снаряжение
решать: решать
хотеться: хочется
оборудовать: оборудованы оборудовали
сочетать: сочетающий
разнообразный: разнообразные
размер: размерами
или: или
проводной: проводную
описание: описание
матрица: матрицей
двухсторонний: двухстороннюю
тоже: тоже
светло: светло
планироваться: планируется
ультразвуковой: ультразвуковому
поверхность: Поверхность
основной: основные
комбинация: комбинация
разговор: разговора
иметь: имеет
отмечать: отмечают
влага: влаги
работать: работающий
увлечение: увлечений
золотой: золотой
интернет: интернет
объектив: объективов
пыл: пыле
есть: есть
элемент: элементы
быстро: быстро
прочий: прочих
возможность: возможность
каталог: каталог
петербург: Петербург
стекло: стекло
особенность: особенностей
они: ним
операционный: Операционная
общение: общения
ошибка: ошибки
ещё: еще
простой: простого
сюда: сюда
почта: Почта
название: названию
ты: тебе
предлагать: предлагает
свобода: свободу
лицевой: Лицевую
лишиться: лишилась
оборудование: оборудование
объём: Объем
беспроводный: беспроводную
тут: тут
обсудить: обсудить
восьмиядерный: восьмиядерного
текстовый: текстовый
быстрый: быструю
решение: решение
быть: будет
параметр: параметрам
раз: раз
сотрудник: сотрудников
