съёмка: Съемка съемка
если: если
цифровой: цифровой
подключение: подключения
идти: ИДЕТ идет
выбор: выбором
барометр: барометр
помочь: поможет
кто: кто
стабилизация: Стабилизация
мач: мАч
строительство: строительства
блок: блок
тип: Тип
процессор: процессора процессор
цена: цены ценами цен
крышка: крышка крышки
электроника: электроника
видео: видео
гаджет: Гаджеты
многое: многое
выходной: выходные
снаряжение: снаряжение
модуль: модуль модуля
вхшхта: ВхШхТ
дисплей: дисплее Дисплей дисплей
москва: Москва
код: Код
отпечаток: отпечатка
телега: телегу
задний: Задняя
хотеться: хочется
внимание: Внимание
разнообразный: разнообразные
россия: России Россия
бытовой: Бытовая бытовая
сорянин: СОРЯН
список: СПИСКОВ списком
материал: Материал
тот: тех
цвет: Цвет
встроить: Встроенная
глянцевый: глянцевая
карта: карт Карта карты карта
связь: связи
вес: Вес
искать: Искать искать
модель: Модель модели
помогать: помогать
работа: работе работы
скорый: скором
производитель: производителя
или: или
вспышка: Вспышка
сайт: сайт
отзыв: Отзывы отзывы
удобный: удобный
при: при
что: что
частота: Частота
удобно: удобно
компас: компас
зарядка: зарядки зарядка
где: Где
описание: описание
технический: технические
отсутствовать: отсутствует
санкт: Санкт
порт: Порты порты
нужный: нужные
подробный: подробная
технология: Технология
планироваться: планируется
мощность: Мощность
стереозвук: стереозвук
определяться: определяется
всё: все
купить: купить
светосила: Светосила
компьютер: Компьютеры компьютеры
металл: металл
ультраширокий: Ультраширокий
для: для Для
шумоподавление: шумоподавление
общий: Общее
восстановить: восстановить восстановлен восстановленный
рамка: рамки
покупатель: покупателю
корпус: корпус
предложение: предложение
самый: самые самое
смартфон: Смартфон
поиск: поиска поиск
сравнение: сравнения сравнение
основный: Основная
слот: Слот
основной: Основной
сканер: сканер
оперативный: Оперативная
интернет: интернет
раздел: разделе разделы
каждый: каждом каждый каждой
объектив: объективов объектив
размер: Размеры
время: время времени
я: мне
реверсивный: реверсивная
выше: выше
спецификация: Спецификация
стандарт: Стандарты
сервис: сервис
группа: групп
коммуникация: Коммуникации Коммуникация
быстро: быстро
экран: экран экране
форма: Форм
фактор: фактор
так: так
находиться: находиться находится
оценка: Оценка
аппаратный: Аппаратная
замедлить: Замедленная
туристический: туристическое
свободный: свободное
подбор: подбор
задача: задача
находить: находить
телеобъектив: Телеобъектив
ресурс: ресурс
ультразвуковой: ультразвуковой
датчик: датчик
изображение: изображения
влагозащита: Влагозащита
возможность: возможность возможности
сравнить: сравнить
каталог: каталог
многофункциональный: многофункциональный
информация: информация
петербург: Петербург
который: которая
меняться: меняется
пилить: пилим
наименее: наименее
навигация: Навигация навигация
стекло: стекло
часть: часть
детский: детские
писать: писать пишите
питание: Питание
мина: мин
графический: Графический
фильтр: Фильтры
стабильный: стабилен
операционный: Операционная
почти: почти
комплектация: Комплектация
наш: Наша
выгодный: выгодное
страница: странице
ошибка: ошибки
доступный: доступен
ещё: еще Еще
сюда: сюда
беспроводный: Беспроводная беспроводной
название: названию
день: дни день
руб: руб
быстрый: быстрой
зарядный: зарядное
аккумулятор: аккумулятора
маркировка: Маркировка
охватывать: охватывать
устройство: устройство
ггц: ГГц
именно: именно
позволять: позволяющий
себя: собой
другой: другое
чип: чип
оз: ОЗУ
фонарик: фонарик
магазин: магазинов магазинах
характеристика: характеристики Характеристики
техника: техника
обзор: обзора
система: система
память: память памяти
инструмент: Инструмент
фронтальный: Фронтальная
товарный: Товарная
оборудование: оборудование
оптический: оптическая
авто: Авто
вечером: вечером
товар: товаров товары
там: Там
освещение: освещения
полностью: полностью
угол: Угол
сенсорный: сенсорный
разработка: разработке разработка
автотовар: автотовары
соотношение: Соотношение
ядро: ядер
островной: островная
категория: категории
обсудить: обсудить
климат: Климат
полезный: полезные
конкретный: конкретные
отладка: ОТЛАДКА
текстовый: текстовый
ёмкость: Емкость
гироскоп: гироскоп
между: между
кол: Кол
камера: камера
ремонт: ремонта
решение: решение
быть: будет
как: как
аудио: Аудио
площадка: площадке
функция: Функции
бренд: Бренд
принять: принять
ссылка: ссылки
фото: фото
параметр: параметрам
калибровка: калибровка
глонасс: ГЛОНАСС
