съёмка: Съемка
если: если
выбор: выбором
возрастание: возрастанию
начало: Начало
проприетарный: проприетарная
помочь: поможет
кто: кто
товар: Товары товаров товары
строительство: строительства
закладка: Закладки
блок: блок
процессор: процессора
цена: цены ценами цен Цены
электроника: электроника
видео: видео
сортировка: Сортировка
гаджет: Гаджеты
многое: многое
выходной: выходные
снаряжение: снаряжение
параметр: ПАРАМЕТРАМ параметрам
телега: телегу
хотеться: хочется
внимание: Внимание
разнообразный: разнообразные
бытовой: Бытовая бытовая
тот: тех
вес: Вес
искать: Искать искать
модель: Модель модели
помогать: помогать
работа: работе работы
скорый: скором
или: или
сайт: сайт
удобный: удобный
где: Где
описание: описание
технический: технические
нужный: нужные
подробный: подробная
планироваться: планируется
определяться: определяется
всё: все
купить: купить
компьютер: Компьютеры компьютеры
модуль: модуля
подбор: ПОДБОР подбор
восстановить: восстановить восстановлен восстановленный
для: для Для
покупатель: покупателю
предложение: предложение предложениям
произодитель: Произодители
самый: самые самое
пикс: пикс
смартфон: Смартфон Смартфоны
дисплей: Дисплей
поиск: поиска поиск
сравнение: сравнения сравнение Сравнение
основный: Основная
оперативный: Оперативная
количество: Количество
раздел: разделе разделы
интернет: интернет
отзыв: отзывы
каждый: каждом каждый каждой
объектив: объективов
пред: Пред
время: время времени
я: мне
есть: есть
показать: показать Показать
сервис: сервис
история: История
быстро: быстро
экран: экран
находиться: находиться находится
так: так
туристический: туристическое
свободный: свободное
находить: находить
ресурс: ресурс
возможность: возможность
сравнить: сравнить Сравнить
информация: информация
вечером: вечером
каталог: каталог
многофункциональный: многофункциональный
который: которая
пилить: пилим
меняться: меняется
наименее: наименее
детский: детские
писать: писать пишите
стабильный: стабилен
фильтр: Фильтры
операционный: Операционная
почти: почти
выгодный: выгодное
наш: Наша
страница: странице
ошибка: ошибки
доступный: доступен
ещё: еще
сюда: сюда
список: списком
название: названию
день: дни день
руб: руб
охватывать: охватывать
позволять: позволяющий
себя: собой
другой: другое
продажа: продаже
магазин: магазинов магазинах
задача: задача
техника: техника
характеристика: характеристики
удобно: удобно
система: система
память: память памяти
инструмент: Инструмент
оборудование: оборудование
именно: именно
что: что
авто: Авто
там: Там
полностью: полностью
объём: Объем
сенсорный: сенсорный
разработка: разработке разработка
автотовар: автотовары
категория: категории
конец: Конец
обсудить: обсудить
климат: Климат
полезный: полезные
конкретный: конкретные
камера: камер камера
текстовый: текстовый
россия: Россия
между: между
ремонт: ремонта
решение: решение
быть: будет
как: как
аудио: Аудио
след: След
площадка: площадке
принять: принять
алфавит: алфавиту
ссылка: ссылки
фото: фото
идти: идет
