бежевый: Бежевый бежевый
помочь: поможет
блок: блок
фото: Фото фото
электроника: электроника
переопределять: переопределяет
москва: Москва Москве
россия: России Россия
сорянин: СОРЯН
отличный: отличную
мобильный: Мобильный мобильного мобильный
чёрный: черный Черный
челябинск: Челябинску Челябинск
скорый: скором
доставка: Доставка доставкой доставка
технический: технические
камера: камеру камера Камера камеры
санкт: Санкт
подробный: подробная
кам: кам
чебоксары: Чебоксары
компьютер: Компьютеры компьютеры
модуль: модуля
карта: карты карта Карта
для: для Для
восстановить: восстановить восстановлен восстановленный
смартфон: Смартфон смартфон
поиск: поиска поиск
год: год
мпикс: МПикс
бытовой: бытовая Бытовая
новгород: Новгород
любой: любые любую Любой
я: мне
сервис: сервис
интерфейс: интерфейса
фактор: фактор
основный: основная Основная
туристический: туристическое
стиль: стилей
цвет: цветов Цвет
китайский: китайского
находить: находить
галаксить: Галакси
ресурс: ресурс
купить: Купить купить
курск: Курск
сравнить: сравнить
информация: информация
пилить: пилим
детский: детские
аккумулятор: Аккумулятор аккумулятор
выгодный: выгодное выгодной
страница: странице
совпадать: совпадают
тверь: Тверь
доступный: доступен
список: списком СПИСКОВ
официальный: официальный
позволять: позволяющий
задача: задача задачи
стаби: стаби
система: система
инструмент: Инструмент
сдэк: СДЭК
сенсорный: сенсорный Сенсорный Сенсорны
категория: категории
соцсеть: соцсетях
климат: Климат
полезный: полезные
разработка: разработка разработке
скоростной: скоростной
сравнение: сравнение сравнения
зелёный: Зеленый зеленый
себя: себе собой
ссылка: ссылки
нижний: Нижний
самара: Самара
выделяться: выделяется
строительство: строительства
видео: видео
гаджет: Гаджеты
цена: ценам цен цене цены цена ценами
революционный: Революционный
телега: телегу
внимание: Внимание
лаванда: лаванда Лаванда
эффективно: эффективно
работа: работе работы
выбор: выбора выбором
спб: СПБ
удобный: удобный удобной
частота: Частота
где: Где
нужный: нужные
отправка: Отправка
устро: устро
воронеж: Воронеж
профессио: профессио
предложение: предложение
разный: разных
краснодар: Краснодар
курьерский: курьерская
количество: Количество
время: время времени
группа: групп
жизнь: жизни
форма: Форм
производительный: производительный
так: так
свободный: свободное
самовывоз: Самовывоз самовывоз
подбор: подбор
подходящий: подходящего
вечером: вечером
рязань: Рязань
многофункциональный: многофункциональный
который: которая
вариант: Варианты
меняться: меняется
предоплата: предоплате
производитель: Производитель
фильтр: Фильтры
почти: почти
наш: Наша
пикс: Пикс
премиум: премиум
охватывать: охватывать
рынок: рынка
профессиональный: профессиональных
телефон: Телефон телефон
характеристика: характеристики Характеристики
техника: техника
что: что
именно: именно
фронтальный: Фронтальная
товар: товаров товары
магазин: магазинах магазины магазин магазинов
автотовар: автотовары
фантом: Фантом фантом
оперативный: оперативная оперативной Оперативная
ядро: ядер
раздел: разделы разделе
каждый: каждой каждом каждый
между: между
самый: самое самые
как: как
писать: пишите писать
принять: принять
глонасс: ГЛОНАСС
съёмка: Съемка
если: если
идти: ИДЕТ идет
менеджер: менеджеров
тип: Тип
область: область области
легко: легко
выходной: выходные
стабилизация: стабилизация
материал: Материал
тот: тех
вес: Вес
искать: Искать Ищу искать
помогать: помогать
сотовый: Сотовый
гарантия: Гарантия
тем: тем
отзыв: Отзывы отзывы
волоколамский: Волоколамская
процессор: Процессор процессора процессор
встроить: встроенная Встроенная
митино: Митино
определяться: определяется
всё: все
металл: металл
покупатель: покупателю
китай: Китая
модель: модели Модель модель
оптический: Оптическая
млн: млн
город: город
экран: экран Экран экрана
флагманский: флагманский
розовый: розовый
наименее: наименее
бесплатный: бесплатная
стабильный: стабилен
беспровод: Беспровод
супермощный: супермощный
руб: руб
бесплатно: бесплатно
разрешение: Разрешение
ггц: ГГц
повседневный: повседневные
находиться: находится находиться
другой: другое других
проверка: проверки
тариф: тарифам
удобно: удобно
память: память Память памяти
товарный: Товарная
авто: Авто
там: Там
полностью: полностью
день: день дни
способ: способ
кремовый: Кремовый кремовый
новый: новый
конкретный: конкретные
отладка: ОТЛАДКА
версия: версия
ленинградский: Ленинградской
кол: Кол
ремонт: ремонта
аудио: Аудио
площадка: площадке
бренд: Бренд
заявить: заявленным
моноблок: Моноблок
яркий: яркий
изделие: изделия
светло: Светло светло
создатель: создателей
кто: кто
тула: Тула
класс: класса
переосмыслить: Переосмысленный
многое: многое
снаряжение: снаряжение
страна: стран
решать: решать
хотеться: хочется
разнообразный: разнообразные
сочетать: сочетающий
или: или
сайт: сайт
стаб: стаб
описание: описание
планироваться: планируется
лавандовый: Лавандовый
основной: основные
дисплей: Дисплей
увлечение: увлечений
уфа: Уфа
консультация: консультация
интернет: интернет
плюс: Плюс
объектив: объективов
есть: есть
элемент: элементы
быстро: быстро
точка: точку
мур: Муром
возможность: возможность
каталог: каталог
петербург: Петербург
стекло: стекло
самсунг: Самсунг
операционный: Операционная
общение: общения
ошибка: ошибки
ещё: еще
простой: простого
сюда: сюда
почта: Почта
название: названию
липецк: Липецк
ярославль: Ярославль
предлагать: предлагает
свобода: свободу
оборудование: оборудование
объём: Объем
обсудить: обсудить
текстовый: текстовый
решение: решение
быть: будет
московский: Московская
параметр: параметрам
сотрудник: сотрудников
