поддержка: Поддержка
помочь: поможет
год: Год год
блок: блок
электроника: электроника
москва: Москва Москве
россия: России Россия
сорянин: СОРЯН
мобильный: Мобильный
чёрный: черный Черный
город: города городу город
ёмкостный: емкостный
челябинск: Челябинску Челябинск
автономный: автономной
скорый: скором
доставка: Доставка доставка
технический: технические
санкт: Санкт
подробный: подробная
чебоксары: Чебоксары
компьютер: Компьютеры компьютеры
владивосток: Владивосток
модуль: модуля
для: для Для
восстановить: восстановить восстановлен восстановленный
смартфон: Смартфон смартфон
поиск: поиска поиск
низкий: низкая
мпикс: МПикс
бытовой: бытовая Бытовая
новгород: Новгород
моноблок: моноблок Моноблок
я: мне
сервис: сервис
фактор: фактор
туристический: туристическое
находить: находить
галаксить: Галакси
ресурс: ресурс
купить: Купить купить
курск: Курск
сравнить: сравнить
информация: информация
пилить: пилим
детский: детские
кредит: кредит
карта: карта Карты карт Карта
выгодный: выгодное
страница: странице
совпадать: совпадают
тверь: Тверь
доступный: доступен
список: списком СПИСКОВ
аккумулятор: аккумулятора
официальный: официальный
позволять: позволяющий
крутой: крутыми
задача: задача задач
пыль: пыли
система: система
инструмент: Инструмент
сдэк: СДЭК
сенсорный: сенсорный
категория: категории
климат: Климат
полезный: полезные
разработка: разработка разработке
гарантия: гарантия Гарантия
сравнение: сравнение сравнения
камера: камера Камера
зелёный: Зеленый зеленый
ссылка: ссылки
ёмкий: Емкой
высокий: высокий
нижний: Нижний
самара: Самара
строительство: строительства
иной: иные
видео: видео
гаджет: Гаджеты
цена: ценам цен цены цена ценами
еас: ЕАС
телега: телегу
внимание: Внимание
батарея: батареи
лаванда: лаванда Лаванда
цвет: Цвет
графит: графит Графит
работа: работе работы
удобный: удобный
частота: Частота
где: Где
мощный: мощный
нужный: нужные
диагональ: Диагональ
отправка: Отправка
воронеж: Воронеж
хватить: хватит
предложение: предложение
краснодар: Краснодар
курьерский: курьерская
количество: Количество
время: время времени Время
группа: групп
белый: белый Белый
форма: Форм
екатеринбург: Екатеринбург
так: так
свободный: свободное
самовывоз: Самовывоз самовывоз
подбор: подбор
фиолетовый: фиолетовый Фиолетовый
вечером: вечером
рязань: Рязань
многофункциональный: многофункциональный
который: которая
вариант: Варианты
меняться: меняется
производитель: Производитель
фильтр: Фильтры
почти: почти
наш: Наша
режим: режиме
пикс: Пикс
лайм: Лайм лайм
охватывать: охватывать
себя: собой
много: Много
телефон: Телефон телефон
характеристика: характеристики Характеристики
техника: техника
именно: именно
выводить: выводит
что: что
фронтальный: Фронтальная
товар: товаров товары
магазин: магазинах магазины магазин магазинов магазине
автотовар: автотовары
ядро: ядер
оперативный: оперативная оперативной Оперативная
раздел: разделы разделе
каждый: каждой каждом каждый
между: между
самый: самое самые
как: как
писать: пишите писать
принять: принять
сдек: СДЕК
день: дней день дни
фото: фото
глонасс: ГЛОНАСС
съёмка: Съемка съемки
если: если
идти: ИДЕТ идет
тип: Тип
область: область
выходной: выходные
объём: объем Объем
стабилизация: стабилизация
материал: Материал
пластик: пластик
тот: тех
вес: Вес
искать: Искать Ищу искать
помогать: помогать
сотовый: Сотовый
отзыв: Отзывы отзывы
волоколамский: Волоколамская
процессор: Процессор процессора процессор
возможность: возможностями возможность
встроить: встроенная Встроенная
уровень: уровень
митино: Митино
определяться: определяется
всё: все
покупатель: покупателю
большинство: большинством
модель: модели Модель
фотография: фотографию
разъём: Разъем
защита: защитой
оптический: Оптическая
млн: млн
экран: экран Экран экраном экрана
два: двух
наименее: наименее
стабильный: стабилен
руб: руб
бесплатно: бесплатно
разрешение: Разрешение
ггц: ГГц
находиться: находится находиться
другой: другое других
графитовый: Графитовый
проверка: проверки
тариф: тарифам
удобно: удобно
память: память памяти
товарный: Товарная
авто: Авто
там: Там
яркий: ярким
полностью: полностью
способ: способ
вычислительный: вычислительных
новый: новый
конкретный: конкретные
отладка: ОТЛАДКА
ёмкость: Емкость
жёлтый: Желтый
кол: Кол
ремонт: ремонта
аудио: Аудио
площадка: площадке
элегантный: Элегантный
бренд: Бренд
заявить: заявленным
изделие: изделия
выбор: выбором
кто: кто
тула: Тула
многое: многое
снаряжение: снаряжение
страна: стран
любой: Любой
хотеться: хочется
разнообразный: разнообразные
максимальный: Максимальный
или: или
сайт: сайт
справиться: справиться
выпуск: выпуска
описание: описание
технология: Технология
планироваться: планируется
лавандовый: Лавандовый
рубль: рублей
разговор: разговора
влага: влаги
дисплей: Дисплей
основный: Основная
уфа: Уфа
консультация: консультация
интернет: интернет
объектив: объективов
быстро: быстро
позволить: позволят
мур: Муром
каталог: каталог
петербург: Петербург
стекло: стекло
самсунг: Самсунг
операционный: Операционная
ошибка: ошибки
ещё: еще
сюда: сюда
почта: Почта
название: названию
липецк: Липецк
ярославль: Ярославль
пэк: ПЭК
оборудование: оборудование
обсудить: обсудить
текстовый: текстовый
решение: решение
быть: будет
московский: Московская
развлекательный: развлекательных
параметр: параметрам
