изменение: изменение изменения
способный: способна
занимать: занимает
помочь: поможет
экстренный: экстренной
привычный: привычного
сверхпрочный: сверхпрочный
профессиональный: профессионального
блок: блок
электроника: электроника
менять: менять
передний: переднюю
поддерживать: поддерживает
москва: Москва
остаться: осталась
зум: зумом зум
передовой: передовой
россия: России Россия
сорянин: СОРЯН
обновление: обновления
мобильный: Мобильный
чёрный: черный Черный
город: города город
челябинск: Челябинску Челябинске Челябинск
скорый: скором
еврокомиссия: Еврокомиссии
оригинальный: оригинальных
доставка: Доставка доставка
беспроводный: беспроводная
новый: Новые новые нового Новый новый
технический: технические
стабилизация: стабилизации стабилизация
санкт: Санкт
подробный: подробная
оптический: Оптический оптический Оптическая оптическим
мощность: Мощность
чебоксары: Чебоксары
она: Она
работать: работает
также: Также также
продвинуть: продвинутых продвинутой
компьютер: Компьютеры компьютеры
модуль: модуля модуль
ниже: ниже
для: для Для
стиль: стиле
восстановить: восстановить восстановлен восстановленный
корпус: корпус
смартфон: Смартфон смартфон смартфонов
поиск: поиска поиск
физический: физические физическую
год: год году
придавать: придают
мпикс: МПикс
бытовой: бытовая Бытовая
новгород: Новгород
получить: получила получили
моноблок: моноблок Моноблок
который: которые которая которого
я: мне
заменять: заменяющая
сервис: сервис
фактор: фактор
кнопка: кнопка
аксессуар: аксессуаров
оптика: оптикой
тонкий: Тонкий тонкие
туристический: туристическое
титановый: титановую титановый
находить: находить
ресурс: ресурс
купить: Купить купить
курск: Курск
сравнить: сравнить
информация: информация
пилить: пилим
обладать: обладает обладают
наличие: наличии
аппарат: Аппарат
впечатляющий: впечатляющим
карта: карта Карта
детский: детские
предыдущий: предыдущем
выгодный: выгодное
страница: странице
совпадать: совпадают
тверь: Тверь
доступный: доступен
способность: способностью
сам: самой
список: списком СПИСКОВ
теперь: Теперь
официальный: официальный
позволять: позволяющий
система: системой Система
задача: задача
пыль: пыли
модель: моделями модели Модель
район: район
инструмент: Инструмент
сдэк: СДЭК
вместе: вместе
мощный: мощного мощном
категория: категории
климат: Климат
полезный: полезные
разработка: разработка разработке
прочный: прочный
заметный: Заметное
сравнение: сравнение сравнения
самый: самых самое самые
камера: камера Камера камеры
свой: своими
ссылка: ссылки
процессор: процессоре процессора процессором
сенсорный: Сенсорный
требование: требованию
нижний: Нижний
будто: будто
самара: Самара
любой: любой Любой
поверхность: поверхность
строительство: строительства
иной: иные
видеосъёмка: видеосъемки
видео: видео
гаджет: Гаджеты
ноутбучный: ноутбучного
титан: титана Титан титан
цена: ценам цен цены цена ценами
телега: телегу
производительность: производительность производительности
внимание: Внимание
цвет: Цвет
работа: работе работы
команда: команды
распознавание: распознавания
косметический: косметические
новосибирск: Новосибирска Новосибирск
удобный: удобный
где: Где
выделяться: выделяются
нужный: нужные
отправка: Отправка
воронеж: Воронеж
предложение: предложение
прислать: пришли
краснодар: Краснодар
курьерский: курьерская
помимо: помимо
количество: Количество
время: время времени
группа: групп
белый: белый Белый
форма: Форм
так: так
свободный: свободное
матовый: матовое
самовывоз: Самовывоз самовывоз
подбор: подбор
синий: синий Синий
вечером: вечером
рязань: Рязань
многофункциональный: многофункциональный
вариант: Варианты
меняться: меняется
серый: серый
производитель: Производитель
фильтр: Фильтры
почти: почти
наш: Наша
пикс: Пикс
расстояние: расстояние
охватывать: охватывать
оснастить: оснащены оснащена
лишь: лишь
себя: собой
телефон: Телефон телефон
характеристика: характеристики Характеристики
техника: техника
разрешение: разрешением Разрешение
именно: именно
что: что
впечатление: впечатление
товар: товаров товары
магазин: магазинах магазины магазин магазинов
автотовар: автотовары
ядро: ядер
традиция: традициям
раздел: разделы разделе
рамка: рамку рамки рамками
каждый: каждой каждом каждый
между: между
вместо: вместо
как: как Как
писать: пишите писать
записывать: записывать
принять: принять
сдек: СДЕК
фото: фото
глонасс: ГЛОНАСС
оперативный: оперативной
съёмка: Съемка
если: если
изготовить: изготовленный
идти: ИДЕТ идет
один: один Один
увеличение: увеличение
вспышка: вспышка
тип: Тип
область: область
волшебный: волшебный
спутниковый: спутниковой
выходной: выходные
универсальный: универсальная
уровень: уровне уровня
тот: тех
настраивать: настраиваемая
связь: связи
вес: Вес
искать: Искать Ищу искать
помогать: помогать
сотовый: Сотовый
гарантия: Гарантия
отзыв: Отзывы отзывы
взаимодействие: взаимодействия
волоколамский: Волоколамская
встроить: встроенная Встроенная
практически: практически
митино: Митино
сайт: сайте сайт
определяться: определяется
всё: все
другой: другой другое других
покупатель: покупателю
кратное: кратным
натуральный: Натуральный
улучшить: улучшена
кратный: кратный
трёхмерный: трехмерное
гарнитур: гарнитуры
защита: защитой защиту
стильный: Стильный
зарядка: зарядка зарядки
телекамера: Телекамера
скорее: скорее
экран: экран Экран экрана
весь: всю
заявление: заявлениям
копейск: Копейске
переключатель: переключателя
наименее: наименее
стабильный: стабилен
чип: чипа
устройство: Устройство
отличие: отличие
добавить: добавлен
дополнить: дополненной
руб: руб
поддержка: поддержки
клавиша: клавишу
технически: технически
бесплатно: бесплатно
покрытие: покрытие
режим: режимов
дисплей: дисплея Дисплей
находиться: находится находиться
быть: была будет
оставаться: остается
проверка: проверки
тариф: тарифам
глянцевый: глянцевое
представить: представленная
удобно: удобно
два: два
память: память памяти
товарный: Товарная
авто: Авто
там: Там
полностью: полностью
день: день дни
способ: способ
конкретный: конкретные
отладка: ОТЛАДКА
ремонт: ремонта
аудио: Аудио
площадка: площадке
бренд: Бренд
заявить: заявленным
реальность: реальности
оплата: оплаты
выходить: выходя
согласно: Согласно
выбор: выбором
только: только
кто: кто
тула: Тула
обычный: обычные
фокусный: фокусное
многое: многое
снаряжение: снаряжение
страна: стран
бежевый: бежевый
поколение: поколения
хотеться: хочется
разнообразный: разнообразные
ультратонкий: ультратонкими
вода: воды
или: или
предел: пределы
описание: описание
технология: Технология технологией
планироваться: планируется
основной: основные
кабель: кабель
иметь: имеет
влага: влаги
основный: Основная
уфа: Уфа
интернет: интернет
датчик: датчиком
объектив: объективов
есть: есть
быстро: быстро
мур: Муром
возможность: возможность
использоваться: используется
каталог: каталог
петербург: Петербург
ошибка: ошибки
бесконтактный: бесконтактной
ещё: еще
сюда: сюда
название: названию
голосовой: Голосовые
липецк: Липецк
соответствовать: соответствующую
ярославль: Ярославль
стандарт: стандарту
оборудование: оборудование
объём: Объем
обсудить: обсудить
текстовый: текстовый
решение: решение
московский: Московская
звуковой: звуковых
параметр: параметрам
