остаться: остался
мощный: мощных мощного мощный
вес: вес Вес
помочь: поможет
титановый: титановой титанового титановый
привычный: привычного
сверхпрочный: сверхпрочный
блок: блок
электроника: электроника
предыдущий: предыдущей предыдущем
звезда: звездой
менять: менять
этот: этому
функция: функцию
поддерживать: поддерживает поддерживающим
москва: Москва
широко: широко
зум: зумом зум
бескомпромиссный: бескомпромиссную
отвечать: отвечает
россия: России Россия
сорянин: СОРЯН
мобильный: Мобильный
чёрный: черный Черный
город: города город
поколение: поколении поколения
челябинск: Челябинску Челябинске Челябинск
скорый: скором
стать: стал
оригинальный: оригинальных
доставка: Доставка доставка
технический: технические
камера: камеру камера камерой Камера камеры камер
санкт: Санкт
подробный: подробная
оптический: Оптический Оптическая оптическим
чебоксары: Чебоксары
также: Также также
компьютер: Компьютеры компьютеры
данные: данных
модуль: модуля модуль
ниже: ниже
сердце: Сердцем
назначить: назначить
стиль: стиле
для: для Для
восстановить: восстановить восстановлен восстановленный
апскейлер: апскейлер апскейлером
смартфон: Смартфон смартфон смартфонов смартфона
поиск: поиска поиск
физический: физические физическую
год: год
нужный: нужную нужные
мпикс: МПикс
бытовой: бытовая Бытовая
новгород: Новгород
моноблок: моноблок Моноблок
всегда: всегда
я: мне
сервис: сервис
определение: определения
фактор: фактор
аксессуар: аксессуаров
утверждать: утверждает
туристический: туристическое
установить: установлены
находить: находить
отличный: отличным
ресурс: ресурс
купить: Купить купить
курск: Курск
сравнить: сравнить
информация: информация
пилить: пилим
запись: записи
аппарат: Аппарат
детский: детские
карта: карта Карта
боков: боковой
выгодный: выгодное
страница: странице
совпадать: совпадают
тверь: Тверь
доступный: доступен
безусловно: безусловно
способность: способностью
список: списком СПИСКОВ
официальный: официальный
позволять: позволяющий
выглядеть: выглядит
задача: задача
пыль: пыли
район: район
инструмент: Инструмент
сдэк: СДЭК
продумать: продуманную
чип: чипом чип чипа
который: которую которая который
гбитый: Гбит
категория: категории
климат: Климат
полезный: полезные
дтп: ДТП
разработка: разработка разработке
сравнение: сравнение сравнения
самый: самых самое самые
ссылка: ссылки
похвастаться: похвастался
внутри: внутри
сенсорный: Сенсорный
нижний: Нижний
будто: будто
самара: Самара
таки: таки
любой: любой Любой
строительство: строительства
вырез: вырез вырезом
иной: иные
видеосъёмка: видеосъемки
видео: видео
кнопка: кнопку
прочность: прочности
аппаратный: аппаратную аппаратной
гаджет: Гаджеты
ноутбучный: ноутбучного ноутбучным
титан: титана Титан титан
цена: ценам цен цены цена ценами
сделать: сделана
телега: телегу
производительность: производительность Производительность производительности
внимание: Внимание
цвет: Цвет
вместо: Вместо
альтернативный: Альтернативно
работа: работе работы
прошка: прошке
команда: команды
распознавание: распознавания
новосибирск: Новосибирска Новосибирск
удобный: удобный
где: Где
трассировка: трассировкой трассировку
отправка: Отправка
воронеж: Воронеж
оснастить: оснащен
главный: Главной
перо: пере
улучшить: улучшенной
предложение: предложение
пользователь: пользователю
краснодар: Краснодар
курьерский: курьерская
количество: Количество
время: время времени
использовать: используемого
доработать: доработала
группа: групп
белый: белый Белый
форма: Форм
так: так
свободный: свободное
воспользоваться: воспользоваться
самовывоз: Самовывоз самовывоз
подбор: подбор
изображение: изображения
синий: синий Синий
вечером: вечером
рязань: Рязань
многофункциональный: многофункциональный
прим: прим
вариант: Варианты
меняться: меняется
серый: серый
производитель: Производитель
фильтр: Фильтры
почти: почти
наш: Наша
пикс: Пикс
расстояние: расстояние
охватывать: охватывать
лишь: лишь
себя: собой
телефон: Телефон телефон
характеристика: характеристики Характеристики
техника: техника
что: что
именно: именно
товар: товаров товары
магазин: магазинах магазины магазин магазинов
эргономика: эргономику
автотовар: автотовары
ядро: ядер
раздел: разделы разделе
каждый: каждой каждом каждый
между: между
как: как Как
писать: пишите писать
записывать: записывать
принять: принять
сдек: СДЕК
фото: фото
снизиться: снизился
поддержка: поддержкой
новый: новым новейший Новый новый
глонасс: ГЛОНАСС
оперативный: оперативной
съёмка: Съемка
если: если
переключение: переключения
второй: второй
изготовить: изготовленный
передовой: передовую
идти: ИДЕТ идет
обновля: обновле
один: один Один
увеличение: увеличение
вспышка: вспышка
тип: Тип
антикоррозионный: антикоррозионных
область: область
волшебный: волшебный
спутниковый: спутниковой
луч: лучей
выходной: выходные
стабилизация: стабилизация
тот: тех
связь: связи
искать: Искать Ищу искать
помогать: помогать
он: его
сотовый: Сотовый
гарантия: Гарантия
отзыв: Отзывы отзывы
взаимодействие: взаимодействия
волоколамский: Волоколамская
процессор: Процессор процессора процессор процессором
встроить: встроенная встроенным Встроенная
митино: Митино
сайт: сайте сайт
определяться: определяется
всё: все
предоставлять: предоставляя
покупатель: покупателю
кратное: кратным
натуральный: Натуральный
разрешение: разрешение Разрешение
модель: модели Модель
сравнимый: сравнимым
гарнитур: гарнитуры
защита: защитой
звук: звука
свойство: свойств
экран: экран Экран экраном экрана
дисплей: дисплей Дисплей
копейск: Копейске
наименее: наименее
стабильный: стабилен
устройство: Устройство
версия: версии
дополнить: дополненной
руб: руб
мощность: мощности
бесплатно: бесплатно
режим: режимов
ггц: ГГц
находиться: находится находиться
другой: другое других
благодаря: Благодаря
проверка: проверки
тариф: тарифам
удобно: удобно
два: два
память: память памяти
товарный: Товарная
промышленность: промышленности
авто: Авто
там: Там
беспроводный: беспроводной
полностью: полностью
вылазить: вылазит
день: день дни
способ: способ
конкретный: конкретные
отладка: ОТЛАДКА
ремонт: ремонта
аудио: Аудио
площадка: площадке
бренд: Бренд
заявить: заявленным
реальность: реальности
теперь: теперь
оплата: оплаты
сплав: сплава
выбор: выбором
только: только
кто: кто
рамка: рамкой рамка рамок
тула: Тула
класс: класса
свой: своей
универсальный: универсальную
фокусный: фокусное
многое: многое
снаряжение: снаряжение
добавить: добавила
страна: стран
бежевый: бежевый
хотеться: хочется
разнообразный: разнообразные
получить: получило
или: или
настраивать: настраиваемую
общий: общий
зарядка: зарядки зарядкой
предел: пределы
описание: описание
технология: Технология технологией
планироваться: планируется
презентация: презентации
топовый: топовый
кабель: кабель
иметь: имеет
порт: порта
влага: влаги
основный: Основная
уфа: Уфа
основной: Основной
интернет: интернет
объектив: объективов
передача: передачи
есть: есть
быстро: быстро
сенсор: сенсор
можно: можно
скорость: скоростью
мур: Муром
возможность: возможность
использоваться: используется
каталог: каталог
петербург: Петербург
ошибка: ошибки
бесконтактный: бесконтактной
ещё: еще
сюда: сюда
название: названию
голосовой: Голосовые
липецк: Липецк
ярославль: Ярославль
система: систему
сохранять: сохраняя
клавиша: клавиши
оборудование: оборудование
объём: Объем
обсудить: обсудить
флагман: флагман
текстовый: текстовый
решение: решение
быть: будет
московский: Московская
параметр: параметрам
серьёзно: серьезно
