съёмка: Съемка
если: если
нижний: Нижний
самара: Самара
изготовить: изготовленный
идти: ИДЕТ идет
выбор: выбором
только: только
увеличение: увеличение
помочь: поможет
любой: любой Любой
пик: Пик
вспышка: вспышка
кто: кто
тула: Тула
сверхпрочный: сверхпрочный
профессиональный: профессионального
строительство: строительства
иной: иные
блок: блок
тип: Тип
процессор: процессора процессоре
цена: цены ценам цена ценами цен
область: область
видеосъёмка: видеосъемки
электроника: электроника
видео: видео
волшебный: волшебный
гаджет: Гаджеты
многое: многое
титан: титана титан
выходной: выходные
снаряжение: снаряжение
поддерживать: поддерживает
страна: стран
бежевый: бежевый
стабилизация: стабилизация
москва: Москва
телега: телегу
челябинск: Челябинск Челябинску
передовой: передовой
хотеться: хочется
внимание: Внимание
разнообразный: разнообразные
россия: России Россия
бытовой: Бытовая бытовая
экран: Экран экрана
сорянин: СОРЯН
список: СПИСКОВ списком
телефон: телефон Телефон
цвет: Цвет
встроить: Встроенная встроенная
тот: тех
мобильный: Мобильный
вес: Вес
искать: Искать Ищу искать
модель: Модель модели
чёрный: черный Черный
город: города город
работа: работе работы
помогать: помогать
синий: Синий синий
команда: команды
скорый: скором
или: или
гарантия: Гарантия
сайт: сайт
отзыв: Отзывы отзывы
взаимодействие: взаимодействия
новосибирск: Новосибирска Новосибирск
удобный: удобный
доставка: Доставка доставка
волоколамский: Волоколамская
удобно: удобно
фрон: Фрон
где: Где
описание: описание
технический: технические
нужный: нужные
санкт: Санкт
подробный: подробная
технология: Технология технологией
отправка: Отправка
карта: Карта карта
планироваться: планируется
воронеж: Воронеж
оптический: Оптический Оптическая
митино: Митино
чебоксары: Чебоксары
работать: работает
определяться: определяется
всё: все
купить: купить Купить
компьютер: Компьютеры компьютеры
модуль: модуля
для: для Для
восстановить: восстановить восстановлен восстановленный
покупатель: покупателю
натуральный: Натуральный
предложение: предложение
самый: самые самое
смартфон: Смартфон смартфон
краснодар: Краснодар
влага: влаги
дисплей: Дисплей
курьерский: курьерская
физический: физическую физические
белый: Белый белый
поиск: поиска поиск
сравнение: сравнения сравнение
основный: Основная
уфа: Уфа
год: год
стильный: Стильный
количество: Количество
мпикс: МПикс
защита: защитой
интернет: интернет
новгород: Новгород
объектив: объективов
каждый: каждом каждый каждой
раздел: разделе разделы
моноблок: моноблок Моноблок
время: время времени
я: мне
есть: есть
сервис: сервис
группа: групп
камера: камеры камера
быстро: быстро
форма: Форм
фактор: фактор
информация: информация
находиться: находиться находится
так: так
оптика: оптикой
другой: других другое
туристический: туристическое
свободный: свободное
самовывоз: Самовывоз самовывоз
подбор: подбор
находить: находить
ресурс: ресурс
мур: Муром
уровень: уровня
курск: Курск
возможность: возможность
рязань: Рязань
каталог: каталог
многофункциональный: многофункциональный
сравнить: сравнить
вариант: Варианты
петербург: Петербург
который: которая
обладать: обладает
серый: серый
меняться: меняется
пилить: пилим
производитель: Производитель
наименее: наименее
аппарат: Аппарат
детский: детские
новый: Новый новый
писать: писать пишите
стабильный: стабилен
фильтр: Фильтры
зум: зум
устройство: Устройство
почти: почти
выгодный: выгодное
наш: Наша
страница: странице
совпадать: совпадают
тверь: Тверь
пикс: Пикс
ошибка: ошибки
доступный: доступен
ещё: еще
сюда: сюда
название: названию
голосовой: Голосовые
день: дни день
руб: руб
липецк: Липецк
бесплатно: бесплатно
охватывать: охватывать
ярославль: Ярославль
разрешение: Разрешение
ггц: ГГц
официальный: официальный
позволять: позволяющий
себя: собой
проверка: проверки
тариф: тарифам
магазин: магазинов магазинах магазин магазины
характеристика: характеристики Характеристики
техника: техника
пыль: пыли
задача: задача
район: район
инструмент: Инструмент
память: память памяти
товарный: Товарная
оборудование: оборудование
именно: именно
что: что
авто: Авто
сдэк: СДЭК
вечером: вечером
товар: товаров товары
там: Там
полностью: полностью
объём: Объем
разработка: разработке разработка
автотовар: автотовары
ядро: ядер
способ: способ
категория: категории
климат: Климат
обсудить: обсудить
полезный: полезные
конкретный: конкретные
мощный: мощном
отладка: ОТЛАДКА
текстовый: текстовый
между: между
ремонт: ремонта
решение: решение
быть: будет
как: как
аудио: Аудио
титановый: титановый
площадка: площадке
московский: Московская
бренд: Бренд
сдек: СДЕК
принять: принять
ссылка: ссылки
заявить: заявленным
фото: фото
сенсорный: Сенсорный
параметр: параметрам
глонасс: ГЛОНАСС
оперативный: оперативной
