если: если
подключение: подключения
выбор: выбором
помочь: поможет
кто: кто
строительство: строительства
блок: блок
тип: Тип
цена: цены ценам цена ценами цен
электроника: электроника
видео: видео
гаджет: Гаджеты
многое: многое
выходной: выходные
снаряжение: снаряжение
любой: Любой
москва: Москва
телега: телегу
хотеться: хочется
внимание: Внимание
разнообразный: разнообразные
россия: России Россия
бытовой: Бытовая бытовая
тот: тех
искать: Искать Ищу искать
помогать: помогать
работа: работе работы
скорый: скором
или: или
конструкция: Конструкция
сайт: сайт
отзыв: Отзывы отзывы
удобный: удобный
доставка: Доставка доставка
зарядка: зарядки
где: Где
описание: описание
технический: технические
нужный: нужные
санкт: Санкт
подробный: подробная
карта: Карта карта
планироваться: планируется
определяться: определяется
всё: все
купить: купить Купить
компьютер: Компьютеры компьютеры
микрофон: Микрофон
для: для Для
восстановить: восстановить восстановлен восстановленный
покупатель: покупателю
предложение: предложение
модель: модели
самый: самые самое
поиск: поиска поиск
сравнение: сравнения сравнение
разъём: Разъем
раздел: разделе разделы
интернет: интернет
каждый: каждом каждый каждой
время: время времени
я: мне
сервис: сервис
группа: групп
быстро: быстро
город: город
находиться: находиться находится
так: так
туристический: туристическое
свободный: свободное
подбор: подбор
находить: находить
ресурс: ресурс
возможность: возможность
сравнить: сравнить
информация: информация
вечером: вечером
каталог: каталог
многофункциональный: многофункциональный
который: которая
пилить: пилим
петербург: Петербург
меняться: меняется
наименее: наименее
детский: детские
писать: писать пишите
стабильный: стабилен
фильтр: Фильтры
наушник: Наушники
почти: почти
выгодный: выгодное
наш: Наша
страница: странице
совпадать: совпадают
ошибка: ошибки
доступный: доступен
ещё: еще
сюда: сюда
список: списком
название: названию
день: дни день
руб: руб
охватывать: охватывать
официальный: официальный
позволять: позволяющий
себя: собой
другой: другое
проверка: проверки
магазин: магазинов магазинах магазин магазины
задача: задача
характеристика: характеристики Характеристики
техника: техника
удобно: удобно
именно: именно
товарный: Товарная
инструмент: Инструмент
оборудование: оборудование
что: что
авто: Авто
товар: товаров товары
там: Там
полностью: полностью
разработка: разработке разработка
автотовар: автотовары
способ: способ
категория: категории
обсудить: обсудить
новый: новый
климат: Климат
полезный: полезные
конкретный: конкретные
текстовый: текстовый
внутриканальный: внутриканальные
между: между
ремонт: ремонта
решение: решение
быть: будет
как: как
аудио: Аудио
площадка: площадке
бренд: Бренд
принять: принять
ссылка: ссылки
заявить: заявленным
фото: фото
параметр: параметрам
проводной: проводные
идти: идет
