бежевый: Бежевый бежевый
перо: перо
понадобиться: понадобится
размещаться: размещается
помочь: поможет
вместе: Вместе
мач: мАч
нагрузка: нагрузку
профессиональный: профессионального профессиональных
заводский: заводскому
блок: блок
электроника: электроника
уровень: уровню уровня
поддерживать: поддерживает
значение: значения
москва: Москва Москве
отвечать: отвечает
россия: России Россия
сорянин: СОРЯН
работа: работу работе работы работа
обновление: обновления
стандарт: стандарта
мобильный: Мобильный мобильный
чёрный: черный Черный
челябинск: Челябинску Челябинске Челябинск
скорый: скором
доставка: Доставка доставкой доставка
ведущий: ведущим ведущего
технический: технические
камера: камеру камера Камера
квадрокамера: Квадрокамера квадрокамеры
санкт: Санкт
подробный: подробная
начинка: начинка
чебоксары: Чебоксары
сенсорн: Сенсорн
также: Также
компьютер: Компьютеры компьютеры
достигать: достигает
модуль: модуля
он: него Его
для: для Для
продвинуть: продвинутым
восстановить: восстановить восстановлен восстановленный
цифровой: цифровое
смартфон: Смартфон смартфон смартфона смартфоне
энергоёмкий: Энергоемкий
большущий: большущим
технология: технологии
поиск: поиска поиск
год: год
мпикс: МПикс
бытовой: бытовая Бытовая
новгород: Новгород
ультраширик: ультрашириком
трёхкратный: трехкратным
я: мне
сервис: сервис
фактор: фактор
такой: таким
туристический: туристическое
цвет: цветов Цвет
сенсор: сенсором сенсора
самый: Самый самое самые
галаксить: Галакси
находить: находить
ресурс: ресурс
купить: Купить купить
курск: Курск
высокий: высокого высокой высокую
сравнить: сравнить
однако: Однако
план: плане
информация: информация
пилить: пилим
детский: детские
карта: карта Карта
напоминать: напоминающей
выгодный: выгодное выгодной
страница: странице
устройство: устройства
совпадать: совпадают
тверь: Тверь
графический: графический
доступный: доступен
способность: способностью
список: списком СПИСКОВ
адаптер: адаптера
форма: формой Форм
официальный: официальный
позволять: позволяющий
приближение: приближением
задача: задача
пыль: пыли
стать: стать
максимальный: максимальная
район: район
инструмент: Инструмент
таковой: таковой
сдэк: СДЭК
детализация: детализацию детализации
освещённость: освещенности
сенсорный: сенсорный Сенсорный
категория: категории
климат: Климат
полезный: полезные
разработка: разработка разработке
сравнение: сравнение сравнения
невероятный: невероятной
внутренний: внутреннюю
частота: частотой частота Частота
зелёный: Зеленый зеленый
поддержка: поддержка поддержкой
железный: железном
ссылка: ссылки
аппарат: аппаратом
нижний: Нижний
самара: Самара
выделяться: выделяется
под: под
любой: любой любую Любой
строительство: строительства
голубой: голубой
станция: станции
видео: видео
гаджет: Гаджеты
цена: ценам цен цене цены цена ценами
поддерживаться: Поддерживается
предводительство: предводительством
телега: телегу
внимание: Внимание
штатный: штатную
лаванда: лаванда Лаванда
зуммирование: зуммированием
кадр: кадр
гармонично: гармонично
спб: СПБ
блочок: блочок
новосибирск: Новосибирска Новосибирск
удобный: удобный удобной
автономный: автономную
встроить: Встроенный встроенная Встроенная
выраженный: выраженной
где: Где
мощный: мощный
нужный: нужные
наиболее: наиболее
отправка: Отправка
воронеж: Воронеж
стилус: стилус
составлять: составляет
поскольку: поскольку
корпус: корпуса
яркость: яркость
предложение: предложение
краснодар: Краснодар
курьерский: курьерская
пиковый: Пиковая
являться: является
количество: Количество
возможный: возможна
входить: входит
время: время времени Время
питание: питания
группа: групп группы
образ: образом
соответственно: соответственно
так: так
тактовый: тактовая
свободный: свободное
самовывоз: Самовывоз самовывоз
подбор: подбор
зарядка: зарядку
вечером: вечером
рязань: Рязань
многофункциональный: многофункциональный
два: двумя
вариант: Варианты
храниться: хранится
который: которая которого которое
меняться: меняется
производитель: Производитель
фильтр: Фильтры
заявить: заявлена заявленным
почти: почти
наш: Наша
режим: режиме
чёткость: четкости
похвастаться: похвастаться
пикс: Пикс
получаться: получаются
премиум: премиум
охватывать: охватывать
себя: собой
благодаря: благодаря
дюйм: дюймов
телефон: Телефон телефон
характеристика: характеристики Характеристики характеристиках
техника: техника
что: что
именно: именно
фронтальный: Фронтальная Фронтальна
коммуникация: коммуникациями
товар: товаров товары
магазин: магазинах магазины магазин магазинов
ультра: Ультра
автотовар: автотовары
фантом: Фантом фантом
оперативный: оперативная оперативной Оперативная
ядро: ядер
пиксель: пикселей
раздел: разделы разделе
освещение: освещении
каждый: каждой каждом каждый
между: между
как: как
писать: пишите писать
придача: придачу
принять: принять
фото: фото
новый: новым Новый новый новому
глонасс: ГЛОНАСС
съёмка: Съемка
если: если
слот: Слота
батарея: батарея
идти: ИДЕТ идет
менеджер: менеджеров
сородич: сородичей
тип: Тип
нет: нет
область: область области
выходной: выходные
ниша: нише
стабилизация: стабилизация
шедевр: шедевр
защищать: защищает
материал: Материал материалы
тот: тех
вес: Вес
искать: Искать Ищу искать
помогать: помогать
сотовый: Сотовый
гарантия: Гарантия
тем: тем
изогнутый: изогнутый
отзыв: Отзывы отзывы
при: при
волоколамский: Волоколамская
процессор: Процессор процессора процессор
манер: манер
одночасье: одночасье
митино: Митино
сайт: сайте сайт
встречать: встречает Встречайте
всё: все
более: более
определяться: определяется
основной: основной
сочетаться: сочетаются
большой: Большой
покупатель: покупателю
модель: модели Модель модель
расширение: расширения
легенда: легендой
диагональ: диагонали
объём: объемом Объем
мочь: может
защита: защитой
оптический: Оптическая
млн: млн
выше: выше
экран: экран Экран экраном экрана
город: город
разгон: разгону
полчаса: полчаса
аккумулятор: аккумулятор
снимок: снимков
копейск: Копейске
ускоритель: ускоритель
выход: выходе
док: док
розовый: розовый
наименее: наименее
лёт: лету
она: она
приставка: приставкой
бесплатный: бесплатная
стабильный: стабилен
объединение: объединением Объединение
руб: руб
бесплатно: бесплатно
разрешение: Разрешение разрешения
дисплей: дисплея Дисплей
ггц: ГГц
находиться: находится находиться
другой: другое других
подвергнуться: подвергся
оз: ОЗУ
проверка: проверки
тариф: тарифам
удобно: удобно
память: память памяти
кануть: канувшие
передовой: передовыми
товарный: Товарная
авто: Авто
там: Там
полностью: полностью
день: день дни
способ: способ
кремовый: Кремовый кремовый
данный: данного
конкретный: конкретные
отладка: ОТЛАДКА
нит: нит
топовый: топовая
ленинградский: Ленинградской
наладить: налажена
кол: Кол
ёмкость: емкостью
ремонт: ремонта
аудио: Аудио
площадка: площадке
бренд: Бренд
моноблок: Моноблок
изделие: изделия
разогнать: разогнанного Разогнанное
шанс: шансы
железо: железо
светло: Светло
выбор: выбором
кто: кто
влагозащита: влагозащитой
тула: Тула
класс: класса
пользователь: пользователя
заряжаться: заряжается
многое: многое
обеспечивать: обеспечивает
снаряжение: снаряжение
страна: стран
повреждение: повреждений
комплектация: комплектацию
хотеться: хочется
разнообразный: разнообразные
заполучить: заполучила
размер: размерами
или: или
фотография: фотографии
описание: описание
провод: проводу
двухсторонний: двухстороннюю
совершенно: совершенно
планироваться: планируется
лавандовый: Лавандовый
островной: островном
немой: нем
стильный: стильный
разговор: разговора
влага: влаги
слабый: слабой
семейство: семейства
основный: Основная
справиться: справится
уфа: Уфа
консультация: консультация
интернет: интернет
объектив: объективов
разрешать: разрешающей
дизайн: дизайн
линейка: линейке
пыл: пыле
мощность: мощностью
есть: есть
быстро: быстро
подрасти: подросло
условие: условиях
точка: точку
адаптивный: адаптивной
мур: Муром
покупать: покупать
плохой: плохом
возможность: возможность
каталог: каталог
петербург: Петербург
стекло: стекло
самсунг: Самсунг
ошибка: ошибки
ещё: еще
стандартный: стандартных
сюда: сюда
почта: Почта
название: названию
несколько: несколько
отверстие: отверстии
липецк: Липецк
ярославль: Ярославль
оборудовать: оборудовали
фон: фоне
отдельно: отдельно
оборудование: оборудование
прямоугольный: прямоугольной
беспроводный: беспроводную
телевика: телевиками
десятикратное: десятикратным
соседний: соседних
обсудить: обсудить
флагман: флагман
текстовый: текстовый
быстрый: быструю
решение: решение
быть: будет
московский: Московская
параметр: параметрам
